################################################################################
#______________________________________________________________________________#
#______________________________________________________________________________#
#_____________________#########____#######__###________________________________#
#______________________________________________________________________________#
#______________________________________________________________________________#
#______________________________________________________________________________#
#____________________________________________________#########_________________#
#______________________________________________________________________________#
#______________________________________________________________________________#
#_____________############_____________________________________________________#
#______________________________________________________________________________#
#______________________________________________________________________________#
#______________________________________________________________________________#
#______________________________________________________________________________#
#______________________________________##########_______###########____________#
#______________________________________________________________________________#
#______________________________________________________________________________#
#______________________________________________________________________________#
#______________________________________________________________________________#
#______________________________________________________________________________#
#______________________________________________________________________________#
###########____________________________________________________________________#
#_________#___#################________________________________________________#
#______________________________________________________________________________#
#______________________________________________________________________________#
#______________________________________________________________________________#
#______________________________________________________________________________#
#______________________________________________________________________________#
#______________________________________________________________________________#
#______________________________________________________________________________#
#______________________________________________________________________________#
#______________________________________________________________________________#
#______________________________________________________________________________#
#______________________________________________________________________________#
#______________________________________________________________________________#
#______________________________________________________________________________#
#_________________________________________________________###############______#
#______________________________________________________________________________#
#______________________________________________________________________________#
#___________________________________###########________________________________#
#______________________________________________________________________________#
#______________________________________________________________________________#
#______________________________________________________________________________#
#______________________________________________________________________________#
#______________________________________________________________________________#
#______________________________________________________________________________#
#______________________________________________________________________________#
#____________________________#########_________________________________________#
#___________________________############_______________________________________#
#______________________________________________________________________________#
#______________________________________________________________________________#
#______________________________________________________________________________#
#______________________________________________________________________________#
#______________________________________________________________________________#
#______________________________________________________________________________#
#__________________________________________________#############_______________#
#______________________________________________________________________________#
#______________________________________________________________________________#
################################################################################