################################################################################
#______________________________________________________________________________#
#______________________________________________________________________________#
#_____________________#########################________________________________#
#______________________________________________________________________________#
#______________________________________________________________________________#
#______________________________________________________________________________#
#____________________________________________________#########_________________#
#______________________________________________________________________________#
#______________________________________________________________________________#
#_____________############_____________________________________________________#
#______________________________________________________________________________#
#______________________________________________________________________________#
#______________________________________________________________________________#
#______________________________________________________________________________#
#______________________________________############################____________#
#______________________________________________________________________________#
#______________________________________________________________________________#
#______________________________________________________________________________#
#______________________________________________________________________________#
#______________________________________________________________________________#
#______________________________________________________________________________#
###############________________________________________________________________#
###############################________________________________________________#
#______________________________________________________________________________#
#______________________________________________________________________________#
#______________________________________________________________________________#
#______________________________________________________________________________#
#______________________________________________________________________________#
#______________________________________________________________________________#
#______________________________________________________________________________#
#______________________________________________________________________________#
#______________________________________________________________________________#
#______________________________________________________________________________#
#______________________________________________________________________________#
#______________________________________________________________________________#
#______________________________________________________________________________#
#_________________________________________________________###############______#
#______________________________________________________________________________#
#______________________________________________________________________________#
#___________________________________########################___________________#
#______________________________________________________________________________#
#______________________________________________________________________________#
#______________________________________________________________________________#
#______________________________________________________________________________#
#______________________________________________________________________________#
#______________________________________________________________________________#
#______________________________________________________________________________#
#____________________________#########_________________________________________#
#___________________________############_______________________________________#
#______________________________________________________________________________#
#______________________________________________________________________________#
#______________________________________________________________________________#
#______________________________________________________________________________#
#______________________________________________________________________________#
#______________________________________________________________________________#
#__________________________________________________#############_______________#
#______________________________________________________________________________#
#______________________________________________________________________________#
################################################################################